10,10
1,0,7,8,9,0,0,0,0,0
2,0,6,0,10,0,0,0,0,0
3,4,5,0,11,12,13,0,0,0
0,0,0,0,0,0,14,0,0,0
0,0,21,20,19,0,15,0,0,0
0,0,22,0,18,17,16,0,0,0
0,0,23,0,0,0,0,0,0,0
0,0,24,0,0,0,32,33,34,0
0,0,25,0,0,0,31,0,35,0
0,0,26,27,28,29,30,0,36,37
0,2