10,10
0,0,0,0,0,0,0,0,0,0
0,15,16,17,18,19,20,21,0,0
0,14,0,0,0,0,0,22,0,0
0,13,12,11,10,0,0,23,0,0
0,0,0,0,9,0,0,24,0,0
0,0,6,7,8,0,0,25,0,0
0,0,5,0,0,0,0,26,0,0
0,0,4,0,0,0,0,27,0,0
1,2,3,0,0,0,0,28,29,30
0,0,0,0,0,0,0,0,0,0
3,1